C 255,20 ,30

NO ./textures/metal.xpm
SO ./textures/metal2.xpm
EA ./textures/metal3.xpm
WE ./textures/metal4.xpm

F  190, 120, 230

111111111111111111111111111111
111111111000100000000000011111
100000000000000000111000100001
110000100000000000000000001111
100001111111000000010000111111
1110111000000000W0000000000001
111000000000001100000001000011
100000000000000000000000000001
110000000000011110000000000011
100000000000111000000000000011
110000000000111000000000001111
110000000001111000000000000111
111111111111111111111111111111
