

NO ./textures/akatsuki.xpm
SO ./textures/gaara.xpm
EA ./textures/uchiwa.xpm
WE ./textures/uzumaki.xpm

F 220,100,0
C 225,30,0

1111111111111111111111111
100000000000000000000000S000001
1111111111111111111111111