

NO ./textures/akatsuki.xpm
SO ./textures/gaara.xpm
EA ./textures/uchiwa.xpm
WE ./textures/uzumaki.xpm

F 220,100,0
F 220,100,0
C 225,30,0

1111111111111111111111111
1111111111111111S11111111