
NO ./textures/akatsuki.xpm
SO ./textures/gaara.xpm
EA ./textures/uchiwa.xpm
WE ./textures/uzumaki.xpm

F 220  ,100  , 0
C 225 ,  30  , 0

1111111111111111
1010000000000001
1010000100000111
1010000N00010001
1000000000010001
1111111001111111